16 14
18 18 18 18 18 18 18 18 18 18 18 18 -1 -1 -1 -1
0 0 0 0 0 0 0 0 0 0 0 0 0 0 0 0
0 0 0 0 0 0 0 0 0 0 0 0 0 0 0 0
0 0 0 0 0 0 0 0 0 0 0 0 0 0 0 0
0 0 0 0 0 11 0 0 0 0 11 0 0 0 0 0
0 0 11 0 0 0 0 16 17 0 0 0 0 0 0 0
0 0 0 0 0 0 0 0 0 0 0 11 0 0 0 0
0 0 0 0 16 17 0 0 0 0 0 0 0 0 0 0
0 11 0 13 0 0 0 0 0 0 0 12 0 11 0 0
0 0 0 14 0 0 0 0 0 0 0 15 0 0 0 0
11 11 11 6 9 7 4 5 9 7 9 7 10 11 11 11
1 1 1 1 1 1 1 1 1 1 1 1 1 2 2 1
0 0 0 0 0 0 0 0 0 0 0 0 0 0 0 0
0 0 0 0 0 0 0 0 0 0 0 0 0 0 0 0