34 12
36 36 36 36 36 36 36 36 36 36 36 36 36 36 36 36 36 36 36 36 36 36 36 36 36 36 36 36 36 36 36 36 36 36
36 36 36 36 36 36 36 36 36 36 36 36 36 36 36 36 36 36 36 36 36 36 36 36 36 36 36 36 36 36 36 36 36 36
36 36 36 36 36 36 36 36 36 36 36 36 36 36 36 36 36 36 36 36 36 36 36 36 36 36 36 36 36 36 36 36 36 36
36 36 36 36 36 36 36 36 36 36 36 36 36 36 36 36 36 36 36 36 36 36 36 36 36 36 36 36 36 36 36 36 36 36
36 36 36 36 36 47 36 36 36 36 36 36 47 36 36 36 36 36 36 36 36 36 36 36 36 36 36 36 36 36 36 36 36 36
36 47 36 36 36 36 36 36 36 36 36 36 36 36 36 36 36 36 36 36 36 36 36 36 36 36 36 36 36 36 36 36 36 36
36 36 36 36 36 36 36 36 36 47 36 36 36 36 36 47 36 36 36 36 36 36 36 36 36 36 36 36 36 36 36 36 36 36
36 36 36 36 48 49 50 36 36 36 36 48 49 50 36 36 36 36 36 36 36 36 36 36 36 36 36 36 36 36 36 36 36 36
36 47 36 36 36 36 36 36 47 47 36 36 36 36 36 36 36 47 36 36 36 36 36 36 36 36 36 36 36 36 36 36 36 36
36 36 36 51 36 36 36 51 36 36 51 36 36 36 36 51 36 36 36 36 36 36 36 36 36 36 36 36 36 36 36 36 36 36
47 47 47 42 43 44 44 43 40 41 45 43 45 44 44 46 47 47 47 36 36 36 36 36 36 36 36 36 36 36 36 36 36 36
37 38 38 37 38 38 38 37 39 39 38 38 37 37 37 37 37 37 37 37 37 37 37 37 37 37 37 37 37 37 37 37 37 37