34 12
18 18 18 18 18 18 18 18 18 18 18 18 18 18 18 18 18 18 18 18 18 18 18 18 18 18 18 18 18 18 18 18 18 18
18 18 18 18 18 18 18 18 18 18 18 18 18 18 18 18 18 18 18 18 18 18 18 18 18 18 18 18 18 18 18 18 18 18
18 18 18 18 18 18 18 18 18 18 18 18 18 18 18 18 18 18 18 18 18 18 18 18 18 18 18 18 18 18 18 18 18 18
18 18 18 18 18 18 18 18 18 18 18 18 18 18 18 18 18 18 18 18 18 18 18 18 18 18 18 18 18 18 18 18 18 18
18 18 18 18 18 18 18 18 18 18 18 18 18 18 18 18 18 18 18 18 18 18 18 18 18 18 18 18 18 18 18 18 18 18
18 18 18 18 18 22 23 18 18 18 18 18 18 18 22 23 18 18 18 18 18 18 18 18 18 18 18 18 18 18 18 18 18 18
18 18 18 18 18 18 18 18 18 18 18 29 18 18 18 18 18 18 18 18 29 18 18 18 18 18 18 18 18 18 18 18 18 18
18 22 23 18 18 18 18 29 18 18 18 18 18 18 18 29 18 18 18 18 18 18 18 18 18 29 18 18 18 18 18 18 18 18
18 18 18 18 18 18 18 18 18 18 18 18 18 18 18 18 18 18 18 18 18 18 18 18 18 18 18 18 18 18 18 18 18 18
18 18 18 30 32 30 18 18 18 32 31 33 18 18 18 18 18 18 18 18 18 30 33 31 32 18 18 18 31 32 30 18 18 18
29 29 29 24 25 26 26 26 26 25 27 27 27 27 25 25 27 27 27 27 25 25 25 25 25 26 26 26 26 25 28 29 29 29
19 19 19 19 19 19 19 19 19 19 19 19 19 19 19 19 19 19 19 19 19 19 19 19 19 19 19 19 19 19 19 19 19 19